FFPPPPPXX
FFPPPPXXX
PPPXXXXXX
PPXXSSSSS
XXXXSPPPP
XXXXSPPPP
XXXXSSSSS
XXXXXXXXX
RRXXXXXXX
	